##########
#S       #
#   #### #
#     #  #
# ####   #
#      E #
##########
