#############
#S          E#
#   ######## #
# ########## #
#            #
# ############
  #