##############
#S            #
#   ######   #
#           E#
##############
