#############
#S        E #
#   ######  #
# #        ##
#  ########  #
#           #
#############
