############
#S         #
# #### #####
#   #      #
# # ###### #
#        E #
############
