#########
# S  #  #
#   ## E#
#       #
#   #####
#       #
#########
